你说他像窝瓜吧有身子有眼儿的	你说他像窝瓜吧有身子有眼儿的
家长一个一个接孩子都有于读的	家长一个一个接孩子都有手续的
干脱这样吧，我们落白我，你办个学校	干脆这样吧，我们凑点我，你办个学校
鼻子下巴眼睛头发耳杂	鼻子下巴眼睛头发耳朵
麦当茅[UNK]那么大[UNK]系列	麦当茅[UNK]那么大[UNK]系列
两名战土也基本确认	两名战土也基本确认
把这个橘子瓣辨	把这个橘子瓣瓣
冲上舞台给你达花的那个情形啊	冲上舞台给你捧花的那个情形啊
娱乐速选	娱乐速递
一说两军阵前三万个马	一说两军阵前三万个马
應該是說我們可以輕輕森鬆	應該是說我們可以輕輕輕鬆
没想到的大	没想到的大
势为力敌的情况下	势为力敌的情况下
这都是在医生允统的范国之肉	这都是在医生允统的范围之内
生在变团，长在中国	生在美国，长在中国
任何词形容都很苍日	任何词形容都很苍白
七位来自不同空间的宇宙勇土	七位来自不同空间的宇宙勇士
(观众)已经全部站立起来了	(观众)已经全部站立起来了
这两个人又忙于生计	这两个人又忙于生计
穷乡僻境	穷乡僻境
有右举足轻平的作用	有着举足轻平的作用
家长一个一个接孩子都有于绒的	家长一个一个接孩子都有手续的
你说你着他时间长了	你说你着他时间长了
陈奕迅，你最欣赏的女艺人是谁?	陈奕迅，你最欣赏的女艺人是谁？
咀嚼，阻嚼	咀嚼，囫嚼
比知造神病患者拿着刀去砍孩子	比较造神病患者拿着刀去砍孩子
当亚铃举来举去的	当亚铃举来举去的
师博的共同帮助下	师博的共同帮助下
住着你后有了气车，对不对	住着你后有了气车，对不对
感谢幂龙高清偏光太阳镜	感谢暴龙高清偏光太阳镜
南京交通台苦名主持人	南京交通台著名主持人
听的过程当中小学[UNK]不能闲着	听的过程当中小学徒不能闲着
库绊的是夫妻之间的爱与萨伴	牵绊的是夫妻之间的爱与陪伴
很难得把们老师请到这个现场	很难得把何老师请到这个现场
然后真的很谢的所有人给我的旅因	然后真的很谢谢所有人给我的鼓励
一号选手叫作穆雅澜	一号选手叫作穆雅澜
你卖来他不会卖	你卖来他不会卖
不是一直喜欢言承担那种吗	不是一直喜欢言承担那种吗
电竟魔灵，我在那出生	电竞魔灵，我在那出生
而且女通非常使利	而且交通非常使利
孩子五一出点事怎么力	孩子万一出点事怎么办
因为可能比如说你们的姜束上	因为可能比如说你们的拘束上
你要再着见我跟你有一点乐模样	你要再着见我跟你有一点乐模样
十一祝筷子，即将开始	十一双筷子，即将开始
所以我觉得她做到了这个感说	所以我觉得她做到了这个感觉
事安上我没有走过这样子的大秀	事律上我没有走过这样子的大秀
《如果爱》登陆湖北见视	《如果爱》登陆湖北电视
当他出默之后发现	当他出位之后发现
走过这片芦韩坡	走过这片芦苇坡
走不要走的加强的	走不要走的加强的
看谁时机	看谁时机
是凤血卫视	是凤血卫视
第一条胡同，叫水要胡同	第一条胡同，叫水墨胡同
为何历尽拉年没有解决	为何历尽几年没有解决
我到那些曾经帮助	我到那些曾经帮助
全国射箭很乐部赛冠孕	全国射箭俱乐部赛冠军
学校都举办活办	学校都举办活动
震盘全城	震撼全城
郭恩霆，番木瓜的果哭位置真的让人很糊粉	韩恩廷，番木瓜的果实位置真的让人很糊粉
导师们你们可定会记住我	导师们你们一定会记住我
孩子五一出点事怎么办	孩子万一出点事怎么办
当兄弟们正激烈对拉时	当兄弟们正激烈对抗时
也感谢我们的老奇葩来到见场	也感谢我们的老奇葩来到现场
不服你咬我呀!	不服你咬我呀!
我给你捧呢	我给你捧呢
连能比我更嗨	连能比我更嗨
欢迎收看献被频道秀场竞技类栏目	欢迎收看靓妆频道秀场竞技类栏目
好多女亮宾来的时候看不见两边	好多女亮宾来的时候看不见两边
是打在了火蜥螺的顶部装甲	是打在了火蜥蜴的顶部装甲
妈就是刺[UNK]我呢	妈就是刺刺我呢
我们这个天是大家献爱心的时候了	我们这个天是大家献爱心的时候了
从你炙苦的过程当中一路陪你走来	从你贫苦的过程当中一路陪你走来
欢迎太紧队的对立方	欢迎太紧队的对立方
传承中华传绑文化，裙州学子举行孔庙开等礼	传承中华传统文化，福州学子举行孔庙开笔礼
不同的日子一样的尊伤，台湾幼教感受大陆教师节	不同的日子一样的尊尊，台湾幼教感受大陆教师节
我觉得她现在很故松	我觉得她现在很轻松
你愿意做小麦的睛天吗	你愿意做小麦的晴天吗
除非你是破强道	除非你是破强道
艺坛接力圣人传	艺坛接力圣人传
世界大赛中勇奇首权金牌的	世界大赛中勇夺首枚金牌的
向谁谁也不愿意去	向谁谁也不愿意去
他变身都是交村的，带到城里来了	他变身都是农村的，带到城里来了
就者有些家长还外地	或者有些家长还外地
能让人忘记是能的满载的梦想	能让人忘记是能的满载的梦想
是因为我在网上歌泽了	是因为我在网上歌译了
在节目中存雷的时可只有一小时	在节目中存活的时间只有一小时
有请主持人，盒非，郭德闪	有请主持人，孔非，郭德永
城跟你说	就跟你说
馨磬，好	馨馨，好
料涂庙，料涂神儿	料涂庙，料涂神儿
创造一个没有淘太的良性竞手	创造一个没有淘汰的良性竞手
四大名著只有二本	四大名著只有二本
因为有花卤石板材	因为有花烛石板材
邓超使出"邓感光波[UNK]	邓超使出"邓感光波[UNK]
好像从精神病虎逃出来	好像从精神病院逃出来
满嫌的罪名暂定的是	涉嫌的罪名暂定的是
你可以利用服装顾魚的不同啊	你可以利用服装顾色的不同啊
赵立新，毒牙战队将要把这神圣的一票投绍谁	赵立新，毒牙战队将要把这神圣的一票投给谁
从我家骑自行车到这也就光个小时	从我家骑自行车到这也就一个小时
你傻小悦悦这样的事	你像小悦悦这样的事
住着慢后有了汽车，对不对	住着然后有了汽车，对不对
我刚谷大白话	我刚听大白话
李晨，反情票	李晨，反情票
它就是恐龙和拧檬交配	它就是恐龙和柠檬交配
网上有见百首歌	网上有几百首歌
孙时候从知岁开始喜欢唱歌	小时候从几岁开始喜欢唱歌
你要走到前面第一个松棉口	你要走到前面第一个松棉口
是的，晓明(黄晓明)	是的，晓明(黄晓明)
就让我坠入滩	就让我坠入崖
巧对影暖	巧对影暖
其是很多阴星到中国来做宣发	其实很多明星到中国来做宣发
再睁大一点!	再睁大一点!
我是发自肺脐地那么去爱	我是发自肺脐地那么去爱
疯道的小船说翻就翻	疯道的小船说翻就翻
还是我个人的道能	还是我个人的道能
其实早在店朝的时候就已经非常盛行了	其实早在今朝的时候就已经非常盛行了
或者是工车压为大的时候	或者是工车压力大的时候
这个是大概听怖	这个是大概听闻
他们长得太正是了	他们长得太正是了
我很喜欢吃冰浊淋	我很喜欢吃冰湿淋
所以我还说希望他何预餐着	所以我还说希望他们预备着
你们这记性是实在是芯好了	你们这记性是实在是忒好了
这个间红当然解决了	这个问红当然解决了
更温暖的情感交肚	更温暖的情感交流
是一种勝勝胧胧的	是一种朦朦胧胧的
但是蔡依林现在的皮肤我态	但是蔡依林现在的皮肤状态
光实困难模式开启啦	光实困难模式开启啦
我们第一季的选手	我们第一季的选手
没事有点钱就服个毒	没事有点钱就吸个毒
孩子小時候忙子幼儿园的问题	孩子小時候忙乎幼儿园的问题
我们这个天是大家就爱心的时候了	我们这个天是大家献爱心的时候了
星二代公主变励走	星二代公主鼓励走
我就能把他眼珠子把出来	我就能把他眼珠子把出来
当梦全社一都很纠结	当时全社会都很纠结
心中的四个的玉子	心中的四个的玉子
不一宝说是吃火锅	不一宝说是吃火锅
我冠宋队的成员了	我冠军队的成员了
我到那些曾经帮助过你们成长的人	我到那些曾经帮助过你们成长的人
你可以利用服装顾龟的不同啊	你可以利用服装颜色的不同啊
所以我觉得是一个很好知见的朋友	所以我觉得是一个很好知见的朋友
梅花类华诞三十年	梅花花华诞三十年
你是刚出说吗	你是刚出院吗
第一位幸福心愿持有着	第一位幸福心愿持有着
朝气羞勃	朝气羞勃
剃须刃和电吹风一份	剃须刃和电吹风一份
娃哈哈格巨斯特别赞助播出的	娃哈哈格瓦斯特别赞助播出的
驾照，通过改格的国家者试...	驾照，通过改格的国家考试...
江苏徐州雕宁(县)大社村	江苏徐州睢宁(县)大社村
再巩就把你爹见飞了，你信不	再巩就把你爹巩飞了，你信不
甚车还有一些总莫的旁观者	甚至还有一些总校的旁观者
本来就需要勇气跨出[UNK]单身[UNK]这一步	本来就需要勇气跨出[UNK]单身[UNK]这一步
要吃完一辨儿西瓜	要吃完一份儿西瓜
为我守里	为我守里
太家准备好餐巾纸	大家准备好餐巾纸
而且白的，确实是享了福了	而且白的，确实是享了福了
最开始我的父日	最开始我的父母
律师案巍参与本次调解	律师案会参与本次调解
这提的活动，我觉得很载手	这提的活动，我觉得很荣手
本都，你不知道啊	本都，你不知道啊
郭恩霆，番木呱的果哭位置真的让人很糊病	韩恩廷，番木呱的果实位置真的让人很糊病
四海公荒第一美男也好	四海公疆第一美男也好
然后她们作息又不规建	然后她们作息又不规矩
街小八个们的孩子玩弹球，拍三角	街上几个门的孩子玩弹球，拍三角
一位是我们经常一在电视容种节目	一位是我们经常会在电视各种节目
扔下去，陶三春拿刀把龙袍界了	扔下去，陶三春拿刀把龙袍剁了
这么意呀	这么意呀
一个是橫着的	一个是橫着的
还有这么多赵人的里来一起钱加	还有这么多艺人的辈来一起参加
欢迎音乐博主碗豆女孩，小潘鼠	欢迎音乐博主碗豆女孩，小潘鼠
他就会脸恿我妈	他就会怂恿我妈
被警方速捕了	被警方警捕了
一个被思维能力	一个没思维能力
孙时候从卸岁开始喜欢唱歌	小时候从几岁开始喜欢唱歌
这个水里胡同是个什么错见	这个水墨胡同是个什么情况
三个月后女儿甜磬出生	三个月后女儿甜磬出生
[UNK]落仙女半袭裙	飘落仙女半袭裙
大就在喂小燕	大就在喂小燕
还是比较变婉的呢	还是比较委婉的呢
就是二拥的校车事件	就是兰州的校车事件
两位战士是心头一展	两位战士是心头一展
完了我就去了，她一摔掇我	完了我就去了，她一[UNK]掇我
颜含是对的	颜含是对的
更不是那些讲谤小璐公主	更不是那些诽谤小璐公主
瞬间可以变成莎土比亚	瞬间可以变成莎士比亚
再次欢迎太家	再次欢迎太家
就是《兆园春，长沙》	就是《沁园春，长沙》
去说我那些花心劈题的事情	去说我那些花心劈腿的事情
或者再约上三预个好友	或者再约上三五个好友
已经拿到了这鹏百宝图	已经拿到了这辆百宝图
怎么有点像《非诚幻扰》的小孩版	怎么有点像《非诚困扰》的小孩版
尽管过程艰脸万分	尽管过程艰辛万分
是谁世夺不走的因为是心灵之翼	是谁世夺不走的因为是心灵之翼
因为我觉得肥是对我来说	因为我觉得肥皂对我来说
大家好，我是罗派学	大家好，我是罗派学
不是你说这个话是个什么息	不是你说这个话是个什么情
是行踪暴路	是行踪暴路
我觉得爹的这样的一个影视剧	我觉得参的这样的一个影视剧
而团里的老弱胖宅就总是被拎出来躁蹦	而团里的老弱胖宅就总是被拎出来躁躏
跟大伙再乐呵乐啊	跟大伙再乐呵乐啊
也算很勾称	也算很勾称
潘霜籍拼死一搏发艳照的举动	潘霜霜拼死一搏发艳照的举动
我带了顶非常漂竞的帽子	我带了顶非常漂亮的帽子
海拔四干多米的高原	海拔四千多米的高原
看起来更温磬一点	看起来更温馨一点
自从相思河胖见了你	自从相思河畔见了你
你可以利用服装顾色的不同啊	你可以利用服装颜色的不同啊
这时候我就从刚(开始)	这时候我就从刚(开始)
从今天开始每周五晚八点半	从今天开始每周五晚八点半
我还是希望自己上台那一到还是漂宽一点	我还是希望自己上台那一到还是漂宽一点
在人间守望干年	在人间守望千年
他是非常非常[UNK]轴[UNK]的	他是非常非常[UNK]轴[UNK]的
麦咕大电影的首映式的门票哦	麦咭大电影的首映式的门票哦
淇西二十万各族人民	滇西二十万各族人民
现在咱改正开放时代，家里有电视	现在咱改正开放时代，家里有电视
所以我还说希望他何预爸着	所以我还说希望他们预备着
当时我为什么去王府并	当时我为什么去王府[UNK]
我觉得确实是一个等常好的一个人	我觉得确实是一个非常好的一个人
没有人知道字宙是怎么产生的	没有人知道字字是怎么产生的
大为支持	大为支持
层层叠登的小边露出来之后	层层叠叠的小边露出来之后
这个古什喜化当中	这个古代文化当中
师博不是说他老婆生病了	师博不是说他老婆生病了
团为网易考拉海购	因为网易考拉海购
派不快对我崇拜	还不快对我崇拜
人家给拾进来不谢吗	人家给掇进来不谢吗
东刚雪铁龙	东刚雪铁龙
澳洲的一个洒吧的话	澳洲的一个酒吧的话
有一个差错，都居也能看见管一管	有一个差错，邻居也能看见管一管
现众朋友们，大家好	现众朋友们，大家好
一次重型现代少年的行动	一次重型现代少年的行动
我今年刚多加完高考	我今年刚参加完高考
科尔儿大草原	科尔沁大草原
哎是的，其实到了秋各啊	哎是的，其实到了秋冬啊
是重锤机器人颂域的霸主	是重锤机器人领域的霸主
千妈作为见证和陪伴	邬妈作为见证和陪伴
是我穿着《半月传》里面的盔甲	是我穿着《半月传》里面的盔甲
享顾茅庐	享顾茅庐
让风继续收，不忍远离	让风继续收，不忍远离
所以装色跟黑色	所以紫色跟黑色
再下一場什麼三杯威土忌	再下一場什麼三杯威士忌
往往在负穷和患难当中	往往在负穷和患难当中
准备到夏感表去了	准备到夏感州去了
终结者队有机会赢取锦囊	终结者队有机会赢取锦囊
政府天球了一种果断的措施	政府采取了一种果断的措施
伤佛带点唏嘘	仿佛带点唏嘘
见到了他们朝思喜想的人	见到了他们朝思暮想的人
兼葭苍苍，白露为霜	蒹葭苍苍，白露为霜
林去颖突熟要拿出什么	林靖颖突然要拿出什么
准备了也是有(一些日子)	准备了也是有(一些日子)
很温磬啊这个地方	很温馨啊这个地方
紫微星象征着天了	紫微星象征着天了
然后再国来	然后再回来
我们决定把公司内部培训体系搬上舞合	我们决定把公司内部培训体系搬上舞台
我对自己的汗价	我对自己的评价
我真想把这[UNK]自行车	我真想把这辆自行车
嘉微的晨光中	嘉悦的晨光中
传承中华传统文化，相粉学子举行孔面升笔孔	传承中华传统文化，福州学子举行孔面开笔礼
我觉得关钱是搞定马东老师	我觉得请钱是搞定马东老师
那今云我们就来说一下	那今天我们就来说一下
加油，我们的音乐合伙人们	加油，我们的音乐合伙人们
就是他根本就不听指爷	就是他根本就不听指令
爱画画，游冰，还有音乐	爱画画，游冰，还有音乐
(姐姐)	(姐姐)
开始送，有的家其穷	开始送，有的家真穷
皇帝还得让认往他头上	皇帝还得让认往他头上
我们今天参委的双方选手	我们今天参委的双方选手
就是开盾多发期	就是矛盾多发期
盛一伦，《超能陆战队》里面那个	盛一伦，《超能陆战队》里面那个
实际上你的脸型是属于比校小	实际上你的脸型是属于比较小
高凌风呛马阴狼暴君，九把刀评黑暗	高凌风呛马阴狼暴君，九把刀评黑暗
张光远心说，说什么都不示啊	张光远心说，说什么都不行啊
各国都承受这种社会首理的阵雄	各国都承受这种社会管理的阵痛
被无情拖下泥湾的郑恺	被无情拖下泥潭的郑恺
大牌位，少牌位	大牌位，少牌位
这属于话相理不粗	这属于话粗理不粗
她就是来自我们台湾的李冠燕老师	她就是来自我们台湾的李冠慧老师
任风收，任它乱	任风收，任它乱
这个是大概怖俯	这个是大概怖俯
为了开顶鹤	为了开顶鹞
演唱会造理不出他	演唱会造理不出他
都付笑淡中	都付笑淡中
你觉得你国你爸吗	你觉得你是你爸吗
咱们换一別的吧，好吧	咱们换一代的吧，好吧
张靓颗演唱会欲模仿碧昂斯，疯狂甩头当场星倒	张靓颖演唱会欲模仿碧昂斯，疯狂甩头当场晕倒
其实作为一个摇寝歌手	其实作为一个摇滚歌手
没事，没事，[UNK]票就不错了	没事，没事，一票就不错了
到我们家的媳妇要對勤恳恳	到我们家的媳妇要恳勤恳恳
金民律入园[UNK]金姓男神[UNK]排行游	金民律入园[UNK]金姓男神[UNK]排行榜
对本茫目的大力支持	对本栏目的大力支持
就是《逃园春，长沙》	就是《沁园春，长沙》
二月春风似期刀	二月春风似期刀
我叫赵振露	我叫赵振露
十一[UNK]筷子，即将干始	十一双筷子，即将开始
丛林家族的行动并并有条	丛林家族的行动井并有条
你会怎么的	你会怎么的
自从我有了钱，每天都以花钱力乐	自从我有了钱，每天都以花钱休乐
但是我特别不需望大家这么对我	但是我特别不需望大家这么对我
事实上我没有走过这样子的认秀	事实上我没有走过这样子的认秀
挑战踪目结舌的曲目	挑战栏目结舌的曲目
我们今天，[UNK]二三四五六	我们今天，一二三四五六
说呐呐呐呐鸣呐	说呐呐呐呐鸣呐
有右举足轻要的作用	有着举足轻要的作用
在国际上走办腿一定要笔直绝直的	在国际上走秀腿一定要笔直笔直的
荣辱与共，娜有同等机会	荣辱与共，拥有同等机会
更加精彩和剩激的射箭比赛	更加精彩和刺激的射箭比赛
然后真的很请谢所有人给我的战勋	然后真的很请谢所有人给我的战勋
那怎么会被你觉弃了呢	那怎么会被你抛弃了呢
呵我乌龟的中文是什么	呵我乌龟的中文是什么
论这如何证明我是谁?	论这如何证明我是谁?
首先将要有访的就是	首先将要有请的就是
最重要的是不要轻易判断双颜手术	最重要的是不要轻易判断双颚手术
民间美式猪弓高手，那锋	民间美式猎弓高手，郭锋
你喜欢你的校服吗?	你喜欢你的校服吗？
咱们就进人中等收入国家门糙了	咱们就进入中等收入国家门尴了
我想我很适台	我想我很适合
度秒如年谁族的离骚	度秒如年谁族的离骚
每花盛开馥郁芳香	梅花盛开馥郁芳香
到时候我费怎么去调整	到时候我要怎么去调整
太极差不多一年前	太极差不多一年前
我觉得心可以	我觉得心可以
张靓预演唱会欲模仿碧昂斯，疯狂甩头当场星倒	张靓颖演唱会欲模仿碧昂斯，疯狂甩头当场晕倒
我是在叫合院胡同里长大的孩子	我是在四合院胡同里长大的孩子
我們就準储要	我們就準备要
站在岛上甚至可以远跳金门	站在岛上甚至可以远眺金门
橫在家中正中央	橫在家中正中央
和应来儿	和应来儿
他投就到子的问题或者重孙子的问题	他们就孙子的问题或者重孙子的问题
是因为我在呵上翻泽了	是因为我在网上翻译了
呦哟，快快快	呦哟，快快快
所以说，咋天那种事件	所以说，今天那种事件
龙其是看到我这个样子	虽其是看到我这个样子
公主病橫行荧屏	公主病橫行荧屏
为了颠蜜既有观念的机锁	为了颠倒既有观念的机锁
你快小院悦这样的事	你像小悦悦这样的事
有良好的幻通，才能让大家一起成长	有良好的交通，才能让大家一起成长
一大多妻制的时候	一大多录制的时候
我我，我才不眷你喝呢	我我，我才不娶你喝呢
欧巴(哥哥)就是	欧巴(哥哥)就是
连曾说独自莫凭栏	连曾说独自莫凭栏
妈妈们选择[UNK]不将就[UNK]	妈妈们选择[UNK]不将就[UNK]
努力地淘达别人他	努力地淘达别人他
爱画画，游泳，还有普乐	爱画画，游泳，还有娱乐
我们决定把公司内部培训体系被上舞合	我们决定把公司内部培训体系搬上舞台
故官博物院携手八家国家级重点博物馆	故官博物院携手八家国家级重点博物馆
晕能，快走吧	晕能，快走吧
就不能管理好白家的道理	就不能管理好白家的道理
吵不卓的歌远天后，爆不完的人卦奇间	吵不停的歌远天后，爆不完的八卦奇闻
张平，念速来水	张平，念速来水
永自绵阳	永自绵阳
盼只盼桃牵第春春色满园	盼只盼桃李争春春色满园
番番:之前有表演篮球吗	番番:之前有表演篮球吗
勤劳肯千	勤劳肯定
兜七脸还干争呢	兜七脸还干净呢
这倒麻是怎么回事	这倒麻是怎么回事
这样的活动，我觉没很来事	这样的活动，我觉没很荣事
那你绍常要到南京来录像	那你经常要到南京来录像
裔葩说的高跷松	奇葩说的高晓松
你们仨就吃傣菜	你们仨就吃傣菜
这队看起来很器张	这队看起来很紧张
热血的检察官一[UNK]符伟	热血的检察官一[UNK]符伟
农业科技优势，汪助武[UNK]台湾农业卖到以色列	农业科技优势，汪勋武：台湾农业卖到以色列
不同的人对我有不同的汗价	不同的人对我有不同的评价
为什么我刚出虎	为什么我刚出院
我却束手无茉	我却束手无策
我们要举立一个活动	我们要举办一个活动
你叫刘兆圆	你叫刘沁圆
这那下说	这那下说
你要走到前面第一个尴梯口	你要走到前面第一个楼梯口
王吗，你干吗	王吗，你干吗
好像就很融治，很合适	好像就很融合，很合适
我以前学艺术体换的时候	我以前学艺术体系的时候
想不到比平时录的更顺和	想不到比平时录的更顺利
不刚能，没有	不例能，没有
江苏者射箭队领队	江苏省射箭队领队
目中无火	目中无风
选手们等待人场	选手们等待入场
龙江儿女共视愿	龙江儿女共视频
即使在累积了一大拔粉丝的基础上	即使在累积了一大拨粉丝的基础上
打一抢换一个地方	打一抢换一个地方
第一次的座位就可好庆功吗	第一次的座位就可好庆功吗
觉得一只够子和一只乌鹏	觉得一只鸽子和一只乌鹏
没有社会眼务机打跟上	没有社会服务机打跟上
没必要再跃想	没必要再联想
中国好红居这个节目太棒了	中国好邻居这个节目太棒了
就是不盾多发期	就是矛盾多发期
请到何暴来帮忙	请到何炅来帮忙
团体冠界，陈玲	团体冠军，陈玲
台下一个种形的身影	台下一个萎形的身影
住着怪房有了汽车，对不对	住着楼房有了汽车，对不对
快速进入工作状态了	快速进入工作状态了
占有他的时何	占有他的时间
往哪现，你还要怎么巩	往哪巩，你还要怎么巩
哎呀，那大个箱子落死边了	哎呀，那大个箱子落死边了
发晨应该有三点多	发晨应该有三点多
还有江聚京城的各省地道吃食儿	还有江聚京城的各省地道吃食儿
那么什么是欧巴凡哥哥)呢	那么什么是欧巴（哥哥)呢
给他哥来三爷子弄死了	给他哥来三爷子弄死了
特侦组溢权	特侦组溢权
真的很谢谢大象	真的很谢谢大家
你对双预手术感兴趣吗	你对双颚手术感兴趣吗
然后少吃辛辣刺激甜的油作食物	然后少吃辛辣刺激甜的油炸食物
陌生人就会邻里也不可能管你	陌生人就会邻里也不可能管你
成员必须科目前往生存地	成员必须科目前往生存地
今天白二作来不是就这个问题说	今天请二位来不是就这个问题说
当的没有说什么溜催儿这事儿	当时没有说什么溜缝儿这事儿
我们家树林不光名学霸气	我们家树林不光名学霸气
啊琼她究竟去哪了	啊哎她究竟去哪了
追风少正王俊凯	追风少年王俊凯
第一个环节的攻播者	第一个环节的攻播者
这个星连估计没有多大的改变了	这个星途估计没有多大的改变了
京润拦珠特约播映	京润录珠特约播映
这是比较难的一件事情	这是比较难的一件事情
和中国超常人才选技的实践经验	和中国超常人才选技的实践经验
邻美家是上面吗	邹美家是上面吗
哎呀，我还想(睡)	哎呀，我还想(睡)
一位是中国人民大学的教投张鸣先生	一位是中国人民大学的教授张鸣先生
我在道现上很在乎	我在造型上很在乎
[UNK]年过节咋给老师送礼啊	逢年过节咋给老师送礼啊
其是很多明星到中国来战宣发	其实很多明星到中国来战宣发
进行一个排守榜	进行一个排行榜
因为担心无法看炮	因为担心无法看见
十一观筷子，即将开始	十一双筷子，即将开始
他就会脸展我妈	他就会脸展我妈
自费跨越牛球	自费跨越牛球
怎么有点像《非诚勾扰》的小孩版	怎么有点像《非诚勾扰》的小孩版
说是为了创作为了工作的需费	说是为了创作为了工作的需费
都不要在发型上和农着打粉上	都不要在发型上和衣着打扮上
所以这个事道的很牵动着我们的正	所以这个事真的很牵动着我们的心
放在你身边你会习愤吗	放在你身边你会习惯吗
不在财啡馆	不在咖啡馆
你这样容易制利知道吗	你这样容易制利知道吗
大家好，我叫徐精荧	大家好，我叫徐精昊
窦跟我们的冠军们一试高下	要跟我们的冠军们一试高下
就是非常多的那子树	就是非常多的椰子树
今日脱单，[UNK]点不难	今日脱单，一点不难
都不要在发迎上和衣着打扮上	都不要在发型上和衣着打扮上
我们繁个暑假的时尚搭配	我们一个暑假的时尚搭配
妳脸子裡在想有哪些種類	妳脸子裡在想有哪些種類
加[UNK]字只是表象，缺乏安全感才是实质	加[UNK]字只是表象，缺乏安全感才是实质
影视剧当家花日	影视剧当家花日
包括跟帮练都有关系	包括跟锻练都有关系
如果周杰伦和子健能	如果周杰伦和子健能
很快就都决了	很快就决决了
现够的签害会我本人有去现够	现场的签售会我本人有去现场
有时候世叫贾斯丁比阳后援会会长	有时候世叫贾斯森比赛后援会会长
我要改呈纪录	我要改写纪录
不需要孩辩了，没有脚边的时间	不需要狡辩了，没有脚边的时间
胡同坚固的样卵结构	胡同坚固的样同结构
他像也到子的问题或者重孙子的问题	他像也孙子的问题或者重孙子的问题
(新的天地》	(新的天地》
深藏不露是人戒	深藏不露是八戒
想帮助族长参与建设现场	想帮助族长参与建设现场
是打在了火蜥明的顶部装甲	是打在了火蜥蜴的顶部装甲
严重的类风湿柱关节炎患者	严重的类风湿柱关节炎患者
是阿宝在里面踢趨子	是阿宝在里面踢毽子
因为还是比较经验不是在这一方面	因为还是比较经验不是在这一方面
有时候我觉得生活像烹任	有时候我觉得生活像烹饪
就会成为恐龙柠樣	就会成为恐龙柠檬
冲上舞台给你送花的那个情严啊	冲上舞台给你送花的那个情形啊
你们才能更好地奋选	你们才能更好地奋选
收啊吹啊，无所谓勇敢的我	收啊吹啊，无所谓勇敢的我
民族文化如烂辉煌	民族文化灿烂辉煌
驾照，通过兴洛的国家考试...	驾照，通过兴趣的国家考试...
两个非常他套的问题	两个非常俗套的问题
那好谈开重要会以似的保安来严	那好似开重要会议似的保安森严
有没有人在你扫她的时候觉得你辛苦了	有没有人在你扫她的时候觉得你辛苦了
(第十八届梅花奖获得者)	（第十八届梅花奖获得者)
早冰鞋是和冰刀学的	白冰鞋是和冰刀学的
而且交通非常使利	而且交通非常使利
我给你写后	我给你写写
不是很什感	不是很什感
盛一伦，才就是分标到明白到这一点	盛一伦，才就是分标到明白到这一点
大家可以通过栏耳的微博微信	大家可以通过栏耳的微博微信
在真正婆走的时候我就知道	在真正要走的时候我就知道
冬季这样一个盔穿好时机了	冬季这样一个叠穿好时机了
十一[UNK]筷子，即将开始	十一双筷子，即将开始
董子健的辆秘人	董子健的神秘人
它有一个特别大的禁最就是剧速	它有一个特别大的禁略就是剧速
人家上个礼拜在第五太道呢	人家上个礼拜在第五大道呢
但今天又突然[UNK]杀[UNK]出三位新人	但今天又突然[UNK]杀[UNK]出三位新人
我呢。喜歡能讓我心跳加速的人	我呢。喜歡能讓我心跳加速的人
所以搭了一个淡粉包的羊绒围巾	所以搭了一个淡粉包的羊绒围巾
杨伶闲，上海知名女艺人，主持过《东京印象》	杨伶俐，上海知名女艺人，主持过《东京印象》
邻美家在那边	邹美家在那边
我间就以现在开始谈这个话题	我们就从现在开始谈这个话题
这里却是硝姻弥漫的战场	这里却是硝血弥漫的战场
就是非常多的哪子树	就是非常多的椰子树
其实我觉得不用给女明星找猎口	其实我觉得不用给女明星找猎口
有这五个字粒粒背辛苦	有这五个字粒粒皆辛苦
在做上发现的密集的吗吵	在树上发现的密集的蚂吵
咱们位该每多的关注什么	咱们应该多多的关注什么
又给我们带来怎样的秋冬扮認小妙招呢	又给我们带来怎样的秋冬扮靓小妙招呢
还身怀一甲	还身怀一甲
当骁你是因为胖了吗	当时你是因为胖了吗
孩话那么多千什么	废话那么多干什么
生病的完俊和谭	生病的永俊和谭
一你忍忍吧	-你忍忍吧
南马恐龙哥，朱爱	南马恐龙哥，朱爱
那我现在先去买点儿莱吧	那我现在先去买点儿菜吧
好卖实也不会卖	好卖实也不会卖
很真实很，特别	很真实很，特别
土豆片炒士豆片	土豆片炒士豆片
继续为大家有诗到的是	继续为大家有请到的是
温哪打工那个的片	温州打工那个照片
王小女儿	王小女儿
四海八荒第一美男候大可	四海八荒第一美男候大可
感谢量龙高清偏光太阳镜	感谢量龙高清偏光太阳镜
有的时候我特别羡慕老先生	有的时候我特别羡慕老先生
盼只盼桃车争春春色满园	盼只盼桃李争春春色满园
吃饭叫嘎[UNK]	吃饭叫嘎[UNK]
幼儿园脚小学的校园里面交生的	幼儿园和小学的校园里面发生的
一些影视相关的好不的视频	一些影视相关的好玩的视频
今日天注	今日天晴
录都《画壁》王题曲拉果非常好	录录《画壁》主题曲效果非常好
鹿，晗我好紧张呀	鹿，晗我好紧张呀
所以为什么不务正儿呢	所以为什么不务正业呢
全国室外射箭锦标英	全国室外射箭锦标赛
全国射箭俱乐部爽冠界	全国射箭俱乐部赛冠军
政府来歌了一种果断的措施	政府来取了一种果断的措施
我仍决定把公司内部培训体系被上舞合	我们决定把公司内部培训体系搬上舞台
有完，但是不进我们那胡同	有完，但是不进我们那胡同
经才四年的相处	经过四年的相处
这倒底是怎么间事	这倒底是怎么办事
民间关式猎弓高手，郭锋	民间美式猎弓高手，郭锋
当他出戏之后发现	当他出院之后发现
比如《何以笙新默》里边的何以璨	比如《何以笙新默》里边的何以琛
你们家那个小周周怎么为	你们家那个小周母怎么为
还能在女性情感专家，苏梦	还能在女性情感专家，苏芩
绝对是影视圈合金汤匙出生的小公主	绝对是影视圈合金汤匙出生的小公主
风雅顺型公主标杆	风雅顺型公主标杆
姐姐梁女土告诉我们	姐姐梁女士告诉我们
该子以后怎么办	孩子以后怎么办
己贯慷概热心的我	一贯慷慨热心的我
两知搭档	两千搭档
进行考核开给出建议	进行考核开给出建议
大女天我在这儿乘凉	大冬天我在这儿乘凉
其实他比任何一个男子汉都例强	其实他比任何一个男子汉都最强
我觉得璃实是一个非带好的一个人	我觉得确实是一个非常好的一个人
而且我觉得我有些动怕	而且我觉得我有些动作
家里边情感间都进不去人了	家里边情感间都进不去人了
是我这几年省吃位用攒下的	是我这几年省几位用攒下的
很好的很堵齐的四合匠	很好的很凑齐的四合术
不心为欢乐领做最后务力	不心为欢乐颂做最后努力
音拉鲁滋部落	巴拉鲁滋部落
成人痘真的不大好治	成人痘真的不大好治
长城大下开始前四小时	长城大秀开始前四小时
我觉得多加这样的一个院恐剧	我觉得参加这样的一个院场剧
当兄弟们正激烈对拉咖	当兄弟们正激烈对抗时
争分夺秒问赛道	争分夺秒问赛道
恩爱小天妻李技弦子	恩爱小天妻李技弦子
他是最干净纯辩的	他是最干净纯挚的
在国际委场上	在国际赛场上
着一下你	着一下你
然后我老么人在北京工作	然后我老么人在北京工作
娱乐速递候佩岁结婚三个月至会未要说	娱乐速递候几岁结婚三个月至会不要说
潘箱箱拼死一搏发艳照的举动	潘箱箱拼死一搏发艳照的举动
你那时候到哪创土去	你那时候到哪创土去
各懂都水受这种社会管理的阵演	各族都享受这种社会管理的阵痛
艰难的进的老年打	艰难的进的老年凯
这里是韩国的江商	这里是韩国的江州
对活的只有冷气，在为我叹息	对活的只有冷气，在为我叹息
江苏沓射箭队领队	江苏省射箭队领队
那会天带来什么才艺	那今天带来什么才艺
担率的来说	担忧的来说
及各地方电视合的热挥嘉宾	及各地方电视合的热捧嘉宾
看到他们分开的时侯	看到他们分开的时侯
让他去微开心屁呢	让他去敞开心情呢
勃朗专业化拉造型学校	勃朗专业化化造型学校
能够打开面前的这些记亿宝箱	能够打开面前的这些记性宝箱
其实他认为钱是他的表达爱的方量	其实他认为钱是他的表达爱的方量
传承中华传犹文化，调别学子举行孔庙开笔礼	传承中华传统文化，福州学子举行孔庙开笔礼
这么大制作的一个电呢	这么大制作的一个电呢
我们的高肤秘老师，蔡康永老师	我们的高肤慧老师，蔡康永老师
因为当初在闷上有很多热议	因为当初在网上有很多热议
诶，哪个晓得	诶，哪个觉得
一号到底踏不踏实?	一号到底踏不踏实？
这个日都来我家四五回了	这个日都来我家四五回了
雷要一段时间去近应	需要一段时间去回应
人家要用自己并不深遂的眼睛	人家要用自己并不深邃的眼睛
我的心痛竞是	我的心痛也是
在北京脾明群雄	在北京聪明群雄
最夸张应该是一天五次到大次吧	最夸张应该是一天五次到六次吧
这都是在医生允统的范国之内	这都是在医生允统的范围之内
可是我们那时挥一受的是一种安全	可是我们那时候享受的是一种安全
更健担，更好的成长	更健康，更好的成长
他也演不起请保姆的钱	他也掏不起请保姆的钱
我们的这个淇越路	我们的这个滇越路
几十年苦追求无梅无怨	几十年苦追求无悔无怨
全国射箭俱乐部逐冠孕	全国射箭俱乐部赛冠军
后来马老师有一句活打动了我	后来马老师有一句话打动了我
见到了他们朝思薯想的人	见到了他们朝思暮想的人
温外打工那个的片	温州打工那个照片
熟巴来了	热巴来了
还是比较零遊的呢	还是比较零游的呢
总是能头到非常多的东西	总是能买到非常多的东西
一位是我们爱常会在电机各种节目	一位是我们经常会在电视各种节目
贵州最佳少数民族服坑	贵州最佳少数民族服饰
韩恩强，不吃也很饱	韩恩廷，不吃也很饱
左正享青春的年纪	左正享青春的年纪
有點那種挺摸的感觉	有點那種挺摸的感觉
不会像有一些辣到候咙不舒服	不会像有一些辣到喉咙不舒服
已到达马上确认材科状态	已到达马上确认材料状态
可以因了这个愿望	可以除了这个愿望
我落下这个枋根了	我落下这个枋根了
这个古什文化当中	这个古代文化当中
裤花盛开馥都芳香	梅花盛开馥郁芳香
就在这个不船	就在这个不岸
你知道就算大雨让整应城前颠倒	你知道就算大雨让整座城前颠倒
对于妻子提到的这种[UNK]调虎离山[UNK]的传俩	对于妻子提到的这种[UNK]调虎离山[UNK]的伎俩
为了颠覆既有观念的机锁	为了颠覆既有观念的机锁
兼度苍苍，白露为霜	蒹葭苍苍，白露为霜
在艺术上的"靳爸"	在艺术上的"靳爸[UNK]
但是可以共苦都不能同甘的夫妻	但是可以共苦都不能同甘的夫妻
虫子，我以为是把粑	孩子，我以为是勺粑
然后我就只好马上跟他团说	然后我就只好马上跟他们说
我们已经尽力境救她的生命了	我们已经尽力挽救她的生命了
恩是，看来这样的时尚元表啊	恩是，看来这样的时尚元表啊
把拿声送给我们各位	把掌声送给我们各位
让我们等声欢迎这位设计师	让我们等声欢迎这位设计师
她中间也会天意的激我一些东酒	她中间也会天意的激我一些东酒
我们来的是蟒蛇品	我们来的是蟒蛇品
你们各的为战	你们各的为战
父女俩帮要骑行一个小时	父女俩需要骑行一个小时
家长一个一个接孩子都有于续的	家长一个一个接孩子都有手续的
大客天我在这儿來凉	大冬天我在这儿冰凉
好像欢精神病说逃出来	好像欢精神病院逃出来
好人不见	好人不见
谭警官我想跟你台影可以不	谭警官我想跟你台影可以不
所有的音乐台伙人	所有的音乐合伙人
等到结束以后再给能打电话	等到结束以后再给能打电话
童存瑞的童，智慧的慧	童存瑞的董，智慧的慧
让我们举声欢迎这位设计师	让我们举声欢迎这位设计师
直播的时候我还是天业呢	直播的时候我还是天业呢
是凤且卫视	是凤翔卫视
解说，全新升级版的火蜥螺	解说，全新升级版的火蜥蜴
全国室外射箭锦标变	全国室外射箭锦标赛
那怎么会被你趟弃了呢	那怎么会被你抛弃了呢
这个间题当然解决了	这个问题当然解决了
杨伦闲，上海知名女艺人，主持过《东京印象》	杨伦闲，上海知名女艺人，主持过《东京印象》
咱们这该特多的关注什么	咱们应该多多的关注什么
一提到孩子都很到造	一遇到孩子都很贫造
它有一个特别大的票忌就是剧逛	它有一个特别大的票案就是剧透
沙糖桔真诚愿切地敬上	沙糖橘真诚诚切地敬上
他投世到子的问题或者重孙子的问题	他投世孙子的问题或者重孙子的问题
皇帝还得让人住他头上	皇帝还得让人住他头上
料涂宙，糊涂神儿	料涂糊，糊涂神儿
你知道就算大雨让整应城而颠倒	你知道就算大雨让整座城市颠倒
幼儿国和小学的校园里面发生的	幼儿园和小学的校园里面发生的
世纪佳缘的高级副总载	世纪佳缘的高级主总校
有春韩国的北京南锣鼓巷之称	有着韩国的北京南锣鼓巷之称
你又会说女人太员心了	你又会说女人太痴心了
今日精彩预告	今日精彩预告
跑过来做英语视烦的翻泽	跑过来做英语视频的翻译
取而优之的是一场致敬	取而优之的是一场致敬
因为你现在更到各个校国去	因为你现在更到各个校国去
坚守原向，记录真实	坚守原向，记录真实
说跑到什么红甸	说跑到什么红甸
我是故宫博物院的看门人单雾翔	我是故宫博物院的看门人单霁翔
我来喂你喝适	我来喂你喝酒
是人生的火修课	是人生的火修课
《秘园春，长沙》	《沁园春，长沙》
各位现众好	各位现众好
金牌调解员金洪	金牌调解员金洪
去望向更加深速的远方	去望向更加深邃的远方
哪怕遇见再大的风险	哪怕遇见再大的风险
是夏威亮的沙	是夏威夷的沙
去望向更加深遮的远方	去望向更加深邃的远方
陪你耗到走	陪你搬到走
至场疯狂，跳起来	现场疯狂，跳起来
定王过节咋给老师送礼啊	逢年过节咋给老师送礼啊
设计出不尖国际范儿	设计出不尖国际范儿
再加上一个永远不让主持人说活的嘉宾	再加上一个永远不让主持人说话的嘉宾
此时缓缓驶人一架神秘的马车	此时缓缓驶入一架神秘的马车
已是悬崖百丈水	已是悬崖百丈水
钱麟今天有个非常平要的任务	钱麟今天有个非常重要的任务
你们这记性是实在是式好了	你们这记性是实在是忒好了
我们爱的是你的眼笨	我们爱的是你的眼睛
竞然跟自己老婆的男友	竟然跟自己老婆的男友
抓往一种东西叫亲情	抓住一种东西叫亲情
恩是，看来这样的时尚元泰啊	恩是，看来这样的时尚元素啊
金辆万，虽然还在密腹张态	金炳万，虽然还在密腹状态
麦门用来对付张大大的	麦门用来对付张大大的
咱们真该势多的关注什么	咱们应该多多的关注什么
帮朋友推销活	帮朋友推销活
那么在正武比赛之前	那么在正武比赛之前
用她的(吴君如)名言	用她的(吴君如)名言
妈说了，这叫多子多称	妈说了，这叫多子多称
加住一种东西叫亲情	加住一种东西叫亲情
好来，你的梦想我们知道了	好来，你的梦想我们知道了
会去公司里面再练一下台悲	会去公司里面再练一下台剧
我要向东北大棉沃王德顺学习	我要向东北大棉泥王德顺学习
拿钱恋死我吧	拿钱剁死我吧
套开你呀	套开你呀
我真想把这拓自行车	我真想把这辆自行车
所以是一个千古之迷	所以是一个千古之谣
犹有花校俏	犹有花娟俏
创造了很多故点规矩的图案	创造了很多景点规矩的图案
曾参与中史电视台	曾参与中央电视台
小我的小镇经过	小我的小镇经过
例如像这个葵形格啊棋盘格啊等等等等	例如像这个萎形格啊棋盘格啊等等等等
从小熏肉一下中国传统文化	从小熏陶一下中国传统文化
一定会是一头零水	一定会是一头海水
欧巴(哥哥)	欧巴(哥哥)
快速进入工作状态上	快速进入工作状态上
因为靠脸的饭	因为靠脸的饭
穿就这样每引谁	穿就这样勾引谁
我对于各个地万那种风士人情	我对于各个地方那种风士人情
用你的手指拯一下	用你的手指抠一下
你也知道我这个人就是话膀	你也知道我这个人就是话筒
所以这个事道的很牵为着我们的心	所以这个事真的很牵为着我们的心
第一陌生世界，而厦车又这么多	第一陌生世界，而且车又这么多
受跟我们的冠军们一试高下	要跟我们的冠军们一试高下
去年有一个实鹿肉的到我们林场	去年有一个实实肉的到我们林场
雅典娜就一(直没出现)	雅典娜首一(直没出现)
街上儿个门的孩子玩弹球，拍三角	街上几个门的孩子玩弹球，拍三角
竞猜播主	竞猜播主
你看我跟刘小今天穿的	你看我跟刘小今天穿的
一起在踢想子的那个感觉	一起在踢毽子的那个感觉
气候宣人，温度宜人	气候温人，温度宜人
游森拍摄遭众人嫌弃	游森拍摄遭众人嫌弃
这冠界的分量就够足的	这冠军的分量就够足的
传承中华传统文化，福州学子举行孔庙升笔礼	传承中华传统文化，福州学子举行孔庙开笔礼
董存瑞的董，智意的慧	董存瑞的董，智意的慧
所以为什么不务正心呢	所以为什么不务正业呢
你刚从医完让出来的	你刚从医院逃出来的
纽约对我的吸引力一定会很人	纽约对我的吸引力一定会很大
现够的签害会我本人有去现场	现场的签售会我本人有去现场
麦咕大电影就要上映了	麦咭大电影就要上映了
需要去医院兰断一下	需要去医院诊断一下
没有身你	没有骗你
李晨，我相信可能瞬了我以外	李晨，我相信可能除了我以外
因为我觉得我还是一个特别正常的正第人	因为我觉得我还是一个特别正常的正常人
一什么呀，现在才来你跑还有什么用	-什么呀，现在才来你跑还有什么用
妈妈们选择[UNK]不将就″	妈妈们选择[UNK]不将就[UNK]
因为双领手术是针对一些凸嘴啊	因为双颢手术是针对一些凸嘴啊
梅花盛开万里春先	梅花盛开万里春先
能让人忘记晕的的蔚载的梦想	能让人忘记晕船的梦载的梦想
全新的登穿的新形象	全新的叠穿的新形象
我现在干杯不醉	我现在干杯不醉
沉默他沉没在深海里	沉默地沉没在深海里
都不要在发型上和农着打扔上	都不要在发型上和衣着打扮上
散落苔案又吹过泪眼	散落苔案又吹过泪眼
几十年苦追来无悔无怨	几十年苦追求无悔无怨
接近于一个成年人脚拿的大小	接近于一个成年人脚腿的大小
(第二十四届梅花奖获得者)	（第二十四届梅花奖获得者)
有请主持人，盛非，郭德纲	有请主持人，盛礼，郭德纲
被无情拖下混湾的郑恺	被无情拖下泥湾的郑恺
有的时候那个衣歌跟那个发型预在那	有的时候那个衣服跟那个发型顶在那
永会服务机构也跟不上	永会服务机构也跟不上
郭萌，黄落，欢迎二位	郭萌，黄蓉，欢迎二位
丽道元的郦	丽道元的郦
我骗在大街上	我骗在大街上
皮鞋很潇酒	皮鞋很潇侈
女生是做服装销害的	女生是做服装销售的
所以没有想到我会在这里《走办)	所以没有想到我会在这里（走秀)
一位是我们经常一在电视名种节目	一位是我们经常会在电视各种节目
对啊，它一个是坚着的	对啊，它一个是坚着的
有一个二	有一个二
那么说到合天了	那么说到合天了
我觉得两实是一个非常好的一个人	我觉得确实是一个非常好的一个人
让我们学声欢迎这位设计师	让我们学声欢迎这位设计师
等于他的父母欢亡	等于他的父母双亡
我他老北京车站	我住老北京车站
总多了都是泪	总多了都是泪
我这个痘现在起来越赖人了	我这个痘现在起来越赖人了
长得环环的男生	长得坏坏的男生
您正在收右到的是	您正在收获到的是
工很上面也是很认真的	工作上面也是很认真的
齐心为欢乐领做最后努力	齐心为欢乐颂做最后努力
能让人感受到白然的穿搭那便是时尚了	能让人感受到突然的穿搭那便是时尚了
阿宝再次回到了太家的视线当中	阿宝再次回到了太家的视线当中
洁瀚星海中	灿瀚星海中
是给子期待和眷恋的	是孩子期待和眷恋的
怎么你就这么糟踢	怎么你就这么糟踢
我觉得会加这#的一个影视剧	我觉得参加这样的一个影视剧
八表准备出招	八表准备出招
很快就解史了	很快就解决了
大家尤其是从后面可以看剑	大家尤其是从后面可以看见
浅哈低唱出口成诗，文思漫天飞舞	嘻哈苦唱出口成诗，文思漫天飞舞
作为哭励	作为鼓励
今日精彩福告	今日精彩預告
全国室外射箭的标爽	全国室外射箭锦标赛
那位朋友极下巴非常严重	那位朋友头下巴非常严重
我们夹定把公司内部培训体系搬上舞合	我们决定把公司内部培训体系搬上舞台
看时马送的信物就一目了然了	看时马送的信物就一目了然了
赶紧真起电话	赶紧拿起电话
我得想鞠啊	我得想辙啊
本来就很爵单	本来就很俗单
然后所以我请了一企	然后所以我请了一下
所有东西全都是我女朋友多下	所有东西全都是我女朋友交下
背骁你是因为胖了吗	背晕你是因为胖了吗
今无培二位来不是就这个问题说	今天请二位来不是就这个问题说
那诗说中的痘痘是真的吗	那诗说中的痘痘是真的吗
就是那么长的漠缅公路	就是那么长的漠缅公路
我觉得我很喜欢她的每概片子	我觉得我很喜欢她的每部片子
很多交实糕	很多芡实糕
都会遇到痘痘的困忧	都会遇到痘痘的困困
也是其梦的终结者	也是其实的终结者
我准各好了	我准备好了
对你笑呵啊	对你笑呵啊
又摘第了一个	又摘第了一个
当梦全社会都很纠结	当时全社会都很纠结
我还诸到了一位设计师	我还请到了一位设计师
叫板冠不冲上前	叫板冠军冲上前
青浦分局徐经派出所的	青浦分局徐经派出所的
五道口男子技校(清华大学)	五道口男子技校（清华大学)
再巩就把你爹现飞了，你信不	再巩就把你爹巩飞了，你信不
我会把你们握起来的	我会把你们握起来的
码年全家提桶鸡	几年全家提桶鸡
也是你衣姆里必备的单品啦	也是你衣服里必备的单品啦
张海很就是一个普普通通的清洁工	张海燕就是一个普普通通的清洁工
当然同时我们会在每期的排乔榜当中	当然同时我们会在每期的排行榜当中
第一拳胡同，叫水要胡园	第一拳胡同，叫水墨胡园
你们准各好了吗	你们准备好了吗
冠哥播出	冠名播出
其实动完双额手术后	其实动完双颚手术后
然后她演绎整个故事的能力很赋	然后她演绎整个故事的能力很强
全明星医美家小水小	全明星医美家小水冰
才能够驾歌	才能够驾驭
或者再约上三福个好友	或者再约上三五个好友
星二什公主变励志	星二位公主变励志
大型励志宽技真人秀	大型励志宽技真人秀
故而天子居往的宫殿被称为紫禁城	故而天子居往的宫殿被称为紫禁城
因为当初在闷上有很多热认	因为当初在网上有很多热闹
跑男团的成员开始了他们[UNK]肝″各种游戏的征程	跑男团的成员开始了他们[UNK]肝[UNK]各种游戏的征程
从你冤苦的过程当中一路陪你走来	从你贫苦的过程当中一路陪你走来
说口秀节国《女魔头驾到》	说口秀节目《女魔头驾到》
遇到了宗月大师(刚大叔)	遇到了宗月大师(刚大叔)
正在进发出新的活力	正在进发出新的活力
江苏体有休闲频道	江苏体育休闲频道
我們來聊個入卦	我們來聊個八卦
见财忘火	见财忘火
工伊上面也是很认赛的	工作上面也是很认为的
咱们道该身多的关注什么	咱们应该多多的关注什么
我期望是昊亦凡	我期望是昊迪凡
荣辱与共，朔有同等机会	荣辱与共，拥有同等机会
垮着小包的刘女士也显得很优雅	挎着小包的刘女士也显得很优雅
及各地方电视台的热岸嘉宾	及各地方电视台的热捧嘉宾
梦来以求的	梦来以求的
她(刚才)挂掉电话了	她(刚才)挂掉电话了
要么我出去力道儿去	要么我出去劫道儿去
大家着划一下球什么	大家策划一下缺什么
帮我解决(问题)	帮我解决(问题)
李晨，孙持一些	李晨，矜持一些
第一陌生世界，而且车不这么多	第一陌生世界，而且车不这么多
充满父爱的沉闰甸的饺子	充满父爱的沉寂甸的饺子
故而人子居住的宫殿被称为紫禁城	故而人子居住的宫殿被称为紫禁城
不是很件感	不是很贫感
潘粤明:尽自己所能展现摇滚魅力	潘粤明:尽自己所能展现摇滚魅力
谢谢大家棒场	谢谢大家立场
万众期待的电影要上快了	万众期待的电影要上映了
磨期子嘞	磨期子嘞
朱学恒喻:马是瘫正，王好似[UNK]娘	朱学恒喻:马是臃正，王好似[UNK]娘
喜之喜青出于蓝胜手蓝	喜之喜青出于蓝胜手蓝
优我经纪公司的顽备艺人们	优我经纪公司的必备艺人们
叫呵楚的姑娘	叫呵楚的姑娘
包括材质的一些碰掩啊	包括材质的一些碰撞啊
然后人此以后我嫁入豪门	然后彼此以后我嫁入豪门
说呐呐呐的呐呐	说呐呐呐呐呐呐
我还是希望自己上台那一郑还是漂究一鼠	我还是希望自己上台那一刻还是漂亮一位
有人不大给钱	有人不大给钱
忍不住化身一条团执的鱼	忍不住化身一条团执的鱼
任务:送给老公最窄福一天当做礼物	任务:送给老公最尊福一天当做礼物
很好的，很整齐的四合匠	很好的，很整齐的四合作
全国射箭俱乐部委亚识	全国射箭俱乐部赛亚军
两眼一摸蹿	两眼一摸瞎
大位首发的跨界歌手	六位首发的跨界歌手
卡罗潘，谜入钩袜之前，要牢记几个规则	卡罗潘，进入钩袜之前，要牢记几个规则
创造一个没有淘大的良性竞争	创造一个没有淘汰的良性竞争
翔须刃和电吹风一份	剃须刃和电吹风一份
往往在冤穷和患难当中	往往在贫穷和患难当中
我的心不再庆倦	我的心不再疲倦
梁女土告诉我们	梁女士告诉我们
金民律入围[UNK]金姓男神[UNK]排行诺	金民律入围[UNK]金姓男神[UNK]排行榜
拜业，对	肄业，对
四海八荒第一美男娱大可	四海八荒第一美男娱大可
干呼万唤始出来	干呼万唤始出来
生在复团，长在中国	生在美国，长在中国
解，说，但是由于前铲的坡度太料	解，说，但是由于前铲的坡度太斜
下来就论一下	下来辩论一下
历生人社一邻里也不可能管你	陌生人社会邻里也不可能管你
来，妈妈给揉操	来，妈妈给揉操
脸庞已经千干净净	脸庞已经干干净净
除非你是被强加	除非你是被强加
娱乐团里边的一个断体	娱乐团里边的一个断体
我们赶贤来介绍一下	我们赶紧来介绍一下
真的是追了好多场导	真的是追了好多场景
那因为我们的减一人	那因为我们的臧一人
巨相都拧巴	巨船都拧巴
来待奉自己的伴侣	来待奉自己的伴侣
心不在馬	心不在乎
今天跆二位来不是就这个问题说	今天请二位来不就就这个问题说
其实我心里刚才有点周长	其实我心里刚才有点周长
唱的这个(歌)唱得不错	唱的这个(歌)唱得不错
你怎么样去平窗	你怎么样去平仄
你八一座	你八一座
这也是我第一次多加上海时装周	这也是我第一次参加上海时装周
动物是可以最近人羞的	动物是可以最近人羞的
幸福心愿持有吉上场之前	幸福心愿持有吉上场之前
麦当旁[UNK]那么大[UNK]系到	麦当劳[UNK]那么大[UNK]系列
笑傲江机人气选子	笑傲江风人气选子
不同的日子一样的尊师，台湾幼数感受大陆教师节	不同的日子一样的尊师，台湾幼儿感受大陆教师节
那些钱进去都是自给医院的	那些钱进去都是自务医院的
然后呢他(前夫)就找他拼命嘛	然后呢他(前夫)就找他拼命嘛
民族文化和烂辉煌	民族文化灿烂辉煌
大家好，我是本期房主的朋友邵恰	大家好，我是本期房主的朋友邵琍
下法这两个字是什么意思啊	下法这两个字是什么意思啊
读完之后你就觉得它谈谈的	读完之后你就觉得它谈谈的
因为我作为观会的时候我是	因为我作为观会的时候我是
番番:是第一次来北京吗	番番:是第一次来北京吗
咱们位设持多的关注什么	咱们应该多多的关注什么
有的的候那个农歌跟那介发型顶在那	有的时候那个衣歌跟那个发型顶在那
当然全让会都很纠结	当然全场会都很纠结
这也是我第一次会加上海时表周	这也是我第一次参加上海时表周
是美丽不涂人，要有温底又要有风度	是美丽不冻人，要有温度又要有风度
他想自不起请保姆的钱	他想掏不起请保姆的钱
寄回到我们麦咕先锋的编辑部	寄回到我们麦咭先锋的编辑部
当然，如果你们都排了	当然，如果你们都排了
鸡年全家提橱鸡	鸡年全家提桶鸡
叫陶三春，带着只返朝把皇城围了	叫陶三春，带着只返朝把皇城围了
但相比于门[UNK]的问题来说	但相比于门尴的问题来说
有的时候那介衣服跟那个发型顶在那	有的时候那个衣服跟那个发型顶在那
不莱就不来	不听就不来
樊梨花的樊，玲球的玲	樊梨花的樊，玲珑的玲
谭警宫挺好难得见	谭警官挺好难得见
这俩人就是吃货界的谁雄双煞	这俩人就是吃货界的雍雄双颚
这样的活动，我觉得很来牵	这样的活动，我觉得很荣幸
我们今天节自当中也请到了我们	我们今天节目当中也请到了我们
《真的即兴说唱你知道我怎么做的)	《真的即兴说唱你知道我怎么做的）
而且成为本场的播主了	而且成为本场的擂主了
首先感谢真心椒滴福品牌	首先感谢真心椒滴滴品牌
就是兰拥的校车事件	就是兰州的校车事件
况呐呐呐呐呐呐	呐呐呐呐呐呐呐
为了生符才吃，为了吃而生存	为了生存才吃，为了吃而生存
冬李这样一个登穿好时机了	冬季这样一个叠穿好时机了
你是我们经常会在电视各种节目	你是我们经常会在电视各种节目
争夺热血街舞团的菜耀	争夺热血街舞团的荣耀
包话接送，现在已经不算什么事了	包括接送，现在已经不算什么事了
短神到这儿	短袖到这儿
然后今吃辛辣刺激甜的油怕食物	然后少吃辛辣刺激甜的油炸食物
一个慷概又热血的角色	一个慷概又热血的角色
谢谢孩子们，谢谢"高妈"	谢谢孩子们，谢谢"高妈[UNK]
我到那坐曾经帮助	我到那些曾经帮助
国家级裁判，那力平先生	国家级裁判，邵力平先生
它也不是诗词朗诉会	它也不是诗词朗诵会
浙江抗州	浙江杭州
接下来我们奠有请的是	接下来我们要有请的是
你们这记性是实在是迷好了	你们这记性是实在是忒好了
我又看了看我的脏子	我又看了看我的辫子
他似是自己孩子的问题	他似是自己孩子的问题
忙醒的工作开始了小	忙碌的工作开始了小
旅行的，第一张后影	旅行的，第一张摄影
你说我拣脚的是兰蔻	你说我拣脚的是兰蔻
你们准备好了吗	你们准各好了吗
我们已经尽力晚救她的生命了	我们已经尽力挽救她的生命了
在拍的过星中	在拍的过程中
首先用嗅觉登看水果	首先用嗅觉登看水果
有的赞方是大家出点钱	有的地方是大家出点钱
当他出然之后发现	当他突然之后发现
射箭女子团体亚不，张云录	射箭女子团体亚军，张云录
但是同时地见证了	但是同时地见证了
我三欢有什么话想表达	我喜欢有什么话想表达
想要挑战的天颖唱将	想要挑战的天颖唱将
犹有花枝伯	犹有花枝伯
应该不是你这欢啊	应该不是你这欢啊
我出老北京车站	我出老北京车站
温轨打工那个的片	温州打工那个照片
冠名播出的同超大调查	冠名播出的同超大调查
就是动成身很了可以	就是功成身很了可以
工作上厨也是很认真的	工作上面也是很认真的
我的妈妈是老太，我的姨是老二	我的妈妈是老太，我的姨是老二
我也不会奋跑	我也不会奋跑
也会自己	也会自己
陌生人过会邻里也不可能管你	陌生人过会邻里也不可能管你
以前(在网络上模仿)假唱，现在真唱了	以前(在网络上模仿)假唱，现在真唱了
應該是說我們可以整輕鬆鬆	應該是說我們可以輕輕鬆鬆
是人生的必悠课	是人生的必侈课
孩话那么多不什么	废话那么多不什么
姜奸姐姐	姜妍姐姐
真有人给我发和信	真有人给我发和信
在香侈品	在香侈品
[UNK]号门四号门请出票	一号门四号门请出票
大岁半都跳了一年了	六岁半都跳了一年了
所以这个事道的很牵动着我们的吃	所以这个事真的很牵动着我们的心
他跟你剧透了第二李	他跟你剧透了第二季
是有点奢修了，那个一般都是捺脸的	是有点奢侈了，那个一般都是搽脸的
喜怒京乐的一个什么故事	喜怒娱乐的一个什么故事
那我们的比赛马上就窦开始	那我们的比赛马上就要开始
乱人[UNK]金姓男神″排行榜的	乱入[UNK]金姓男神[UNK]排行榜的
本来就需要勇气跨出[UNK]单身″这一步	本来就需要勇气跨出[UNK]单身″这一步
你叫芯奸啊	你叫芯奸啊
第一条胡同，叫水里组同	第一条胡同，叫水墨胡同
事实上我没有走过这样子的人方	事实上我没有走过这样子的大方
就是他根本就不听指分	就是他根本就不听指令
来，这位男土上来	来，这位男士上来
第一欣的座位就可以成功吗	第一旁的座位就可以成功吗
朗读依旧，初心不以	朗读依旧，初心不以
为了颠震既有观念的枷锁	为了颠震既有观念的枷锁
我觉得这祥的话我就心里特别逆反	我觉得这样的话我就心里特别逆反
咱们航进人中等收入国家们指了	咱们航进人中等收入国家们领了
